1111111111111111111111111111
1000000000000000000000000001
100000000000000C000000000001
1000000000000000000000000001
1000000000000000000000000001
10000000000C00000000C0000001
1000000000000000000000000001
10000000000E0000000000000001
1000C00000000000000000000001
1000C00000000000000000000001
1000000000000000000000000001
1010001111010000000000000001
1010001001010P0000C000000001
1010001001010000000000000001
10100010010100000000C0000001
1011101111011110000000000001
1111111111111111111111111111
