1111111111111111111111111111
1000000000000000000000000001
10V000000000000C0000000V0001
100000V0000000V0000000000001
1000000V00000000000000000001
10000000000C00000000C0000001
10000V0000000000000000000001
10000000000E000000V000000001
1000C000000V0000000000000001
1000C0V000000000000000000001
1000000000000000000000000001
1010001111010V00000000000001
1010001001010P0000C00000V001
1010001001010000000000000001
10100010010100000000C0000001
1011101111011110000000000001
1111111111111111111111111111
