11111111111111111111111111111111
10P000000001000C00000000000E0001
10000000000100000000000000000111
1000000000C111000000111111111111
11111C11000100000000000000000001
10000000000000000000000000000001
11010000000000000000000000000001
100111000000000C0000001000C00001
1000010001000000100000C000000001
10C00100000000000001000000000001
10000110000001000000000110000001
11111111111111111111111111111111
