11111111111111111111111111111
1CV00V00000001C1V000V000000C1
10000000000001010000000000001
1000000V000001010000000000001
100000000000000000000V0000001
10V000000000V1010000000000001
11111000011111011111000011111
1P000000000C00V00C00000V000E1
11111000011111011111000011111
100000000000V1010000000000001
1000000000000000000000V000001
10000000V00001010000000000001
10000000000001010000000000001
1C0000V0000001C1V0000000000C1
11111111111111111111111111111
